###########
#  #   #  #
#  #   #  #
#  ########
#  #   #  #
#  #   #  #
########  #
#  #      #
#  #      #
#  #      #
###########